layer0
L04 --- L04 --- L04 --- L04 --- L04 --- L04 --- L04 --- L04 --- L04 --- L04 --- L04 --- L04 L04 L04 --- L04 --- L04 L04 L04 L04 L04 L04 --- 
--- L04 --- L04 --- L04 --- L04 --- L04 --- L04 --- L04 --- L04 --- L04 --- L04 --- L04 --- L04 --- L04 L04 L04 L04 --- L04 --- L04 --- L04 
L04 --- L04 --- L04 --- L04 --- L04 --- L04 --- L04 --- L04 --- L04 --- L04 --- L04 --- L04 --- L04 --- L04 --- L04 L04 L04 L04 --- L04 --- 
--- L04 --- L04 --- L04 --- L04 L04 L04 --- L04 L04 L04 --- L04 --- L04 --- L04 --- L04 --- L04 --- L04 --- L04 --- L04 --- L04 L04 --- L04 
L04 --- L04 --- L04 --- L04 --- L04 --- L04 --- L04 --- L04 --- L04 --- L04 --- L04 --- L04 --- L04 --- L04 --- L04 --- L04 L04 --- L04 --- 
--- L04 --- L04 --- L04 --- L04 --- L04 --- L04 --- L04 --- L04 --- L04 --- L04 --- L04 --- L04 --- L04 --- L04 --- L04 --- L04 L04 --- L04 
L04 --- L04 --- L04 --- L04 --- L04 --- L04 --- L04 --- L04 --- L04 --- L04 --- L04 --- L04 --- L04 --- L04 --- L04 --- L04 L04 --- L04 --- 
--- L04 --- L04 --- L04 --- L04 --- L04 --- L04 --- L04 --- L04 --- L04 --- L04 --- L04 --- L04 --- L04 --- L04 --- L04 --- L04 L04 --- L04 
L04 --- L04 --- L04 --- L04 --- L04 --- L04 --- L04 --- L04 --- L04 --- L04 --- L04 --- L04 --- L04 --- L04 --- L04 --- L04 L04 --- L04 --- 
--- L04 --- L04 --- L04 --- L04 --- L04 --- L04 --- L04 --- L04 --- L04 --- L04 --- L04 --- L04 --- L04 --- L04 --- L04 --- L04 L04 --- L04 
L04 --- L04 --- L04 --- L04 --- L04 --- L04 --- L04 --- L04 --- L0Y --- L04 --- L04 --- L04 --- L04 --- L04 --- L04 --- L04 L04 --- L04 --- 
--- L04 --- L04 --- L04 --- L04 --- L04 --- L04 --- L04 --- L0Y --- L0Y --- L04 --- L04 --- L04 --- L04 --- L04 --- L04 --- L04 L04 --- L04 
L04 --- L04 --- L04 --- L04 L04 L04 --- L04 --- L04 --- L0Y --- L0Y --- L0Y --- L04 --- L04 --- L04 --- L04 --- L04 --- L04 L04 --- L04 --- 
--- L04 --- L04 --- L04 --- L04 --- L04 --- L04 --- L0Y --- L0Y --- L0Y --- L0Y --- L04 --- L04 --- L04 --- L04 --- L04 --- L04 L04 --- L04 
L04 --- L04 --- L04 --- L04 --- L04 --- L04 --- L0Y --- L0Y --- L0Y --- L0Y --- L0Y --- L04 --- L04 --- L04 --- L04 --- L04 L04 --- L04 --- 
--- L04 --- L04 --- L04 --- L04 --- L04 --- L0Y --- L0Y --- L0Y --- L0Y --- L0Y --- L0Y --- L04 --- L04 --- L04 --- L04 --- L04 L04 --- L04 
L04 --- L04 --- L04 --- L04 --- L04 --- L0Y --- L0Y --- L0Y --- L0Y --- L0Y --- L0Y --- L0Y --- L04 --- L04 --- L04 --- L04 L04 --- L04 --- 
--- L04 --- L04 --- L04 --- L04 --- L0Y --- L0Y --- L0Y --- L0Y --- L0Y --- L0Y --- L0Y --- L0Y --- L04 --- L04 --- L04 --- L04 L04 L04 L04 
L04 --- L04 --- L04 --- L04 --- L0Y --- L0Y --- L0Y --- L0Y --- L0Y --- L0Y --- L0Y --- L0Y --- L0Y --- L04 --- L04 --- L04 L04 --- L04 L04 
--- L04 --- L04 --- L04 --- L04 --- L0Y --- L0Y --- L0Y --- L0Y --- L0Y --- L0Y --- L0Y --- L0Y --- L0Y --- L04 --- L04 --- L04 L04 --- L04 
L04 --- L04 --- L04 --- L04 --- L04 --- L0Y --- L0Y --- L0Y --- L0Y --- L0Y --- L0Y --- L0Y --- L0Y --- L0Y --- L04 --- L04 --- L04 L04 L04 
--- L04 --- L04 --- L04 --- L04 --- L04 --- L0Y --- L0Y --- L0Y --- L0Y --- L0Y --- L0Y --- L0Y --- L0Y --- L0Y --- L04 --- L04 --- L04 --- 
L04 --- L04 --- L04 --- L04 --- L04 --- L04 --- L0Y --- L0Y --- L0Y --- L0Y --- L0Y --- L0Y --- L0Y --- L0Y --- L0Y --- L04 --- L04 --- L04 
--- L04 L04 L04 --- L04 --- L04 --- L04 --- L04 --- L0Y --- L0Y --- L0Y --- L0Y --- L0Y --- L0Y --- L0Y --- L0Y --- L0Y --- L04 --- L04 --- 
L04 --- L04 --- L04 --- L04 --- L04 --- L04 --- L04 --- L0Y --- L0Y --- L0Y --- L0Y --- L0Y --- L0Y --- L0Y --- L0Y --- L0Y --- L04 --- L04 
--- L04 --- L04 --- L04 --- L04 --- L0K --- L04 --- L04 --- L0Y --- L0Y --- L0Y --- L0Y --- L0Y --- L0Y --- L0Y --- L0Y --- L0Y --- L04 --- 
L04 --- L04 --- L04 --- L04 --- L04 --- L0G L0O L04 --- L04 --- L0Y --- L0Y --- L0Y --- L0Y --- L0Y --- L0Y --- L0Y --- L0Y --- L04 --- L04 
--- L04 --- L04 --- L04 --- L0J --- L04 L0W L04 --- L04 --- L04 --- L0Y --- L0Y --- L0Y --- L0Y --- L0Y --- L0Y --- L0Y --- L04 --- L04 --- 
L04 --- L04 --- L04 --- L0D --- L0G --- L04 L0W L0O --- L04 --- L04 --- L0Y --- L0Y --- L0Y --- L0Y --- L0Y --- L0Y --- L04 --- L04 --- L04 
--- L04 --- L04 --- L0C --- L0W --- L0F --- L0W --- L04 --- L04 --- L04 --- L0Y --- L0Y --- L0Y --- L0Y --- L0Y --- L04 --- L04 --- L04 --- 
L04 --- L04 --- L0A --- L0W --- L0W --- L0W --- L0O --- L04 --- L04 --- L04 --- L0Y --- L0Y --- L0Y --- L0Y --- L04 --- L04 --- L04 --- L04 
--- L04 --- L07 --- L0W --- L0W --- L0W --- L0W --- L04 --- L04 --- L04 --- L04 --- L0Y --- L0Y --- L0Y --- L04 --- L04 --- L04 --- L04 --- 
L04 --- L0E --- L0W --- L0W --- L0W --- L0W --- L0W L0O L04 --- L04 --- L04 --- L04 --- L0Y --- L0Y --- L04 --- L04 --- L04 --- L04 --- L04 
--- L04 --- L07 L0W L0W L0W L0W --- L0W --- L0W --- L04 --- L04 --- L04 --- L04 --- L04 --- L0Y --- L04 --- L04 --- L04 --- L04 --- L04 --- 
L04 --- L0Q L0W --- L0W --- L0W L0W --- L0W --- L0L --- L04 --- L04 --- L04 --- L04 --- L04 --- L04 --- L04 --- L04 --- L04 --- L04 --- L04 
--- L04 L0R --- L0W --- L0N --- L0W L09 L0W L0W --- L04 --- L04 --- L04 --- L04 --- L04 --- L04 --- L04 --- L04 --- L04 --- L04 --- L04 --- 
L04 --- L0E L0W L0W L0W --- L0W --- L0W --- L0W L0P --- L04 --- L04 --- L04 --- L04 --- L04 --- L04 --- L04 --- L04 --- L04 --- L04 --- L04 
--- L04 --- L09 L0W --- L0W --- L0W --- L0W L0T --- L04 --- L04 --- L04 --- L04 --- L04 --- L04 --- L04 --- L04 --- L04 --- L04 --- L04 --- 
L04 --- L0E L0W --- L0W --- L0W --- L0W --- L0W L0S --- L04 --- L04 --- L04 --- L04 --- L04 --- L04 --- L04 --- L04 --- L04 --- L04 --- L04 
--- L04 L0R --- L0W --- L0W --- L0W --- L0W L0T --- L04 --- L04 --- L04 --- L04 --- L04 --- L04 --- L04 --- L04 --- L04 --- L04 --- L04 --- 
L04 --- L0Q L0W --- L0W --- L0W --- L0W L0T --- L0S --- L04 --- L04 --- L04 --- L04 --- L04 --- L04 --- L04 --- L04 --- L04 --- L04 --- L04 
--- L04 --- L09 L0T --- L0W --- L0W --- L0T L0S --- L04 --- L04 --- L04 --- L04 --- L04 --- L04 --- L04 --- L04 --- L04 --- L04 --- L04 --- 
L04 --- L0Q L0W --- L0W --- L0M --- L0B L0S --- L04 --- L04 --- L04 --- L04 --- L04 --- L04 --- L04 --- L04 --- L04 --- L04 --- L04 --- L04 
--- L04 --- L09 L0W L09 L06 L0B L0M L04 --- L04 --- L04 --- L04 --- L04 --- L04 --- L04 --- L04 --- L04 --- L04 --- L04 --- L04 --- L04 --- 
L04 --- L08 --- L09 L05 L04 --- L04 --- L04 --- L04 --- L04 --- L04 --- L04 --- L04 --- L04 --- L04 --- L04 --- L04 --- L04 --- L04 --- L04 
--- L04 --- L08 --- L04 --- L04 --- L04 --- L04 --- L04 --- L04 --- L04 --- L04 --- L04 --- L04 --- L04 --- L04 --- L04 --- L04 --- L04 --- 
L04 --- L04 --- L04 --- L04 --- L04 --- L04 --- L04 --- L04 --- L04 --- L04 --- L04 --- L04 --- L04 --- L04 --- L04 --- L04 --- L04 --- L04 
--- L04 --- L04 --- L04 --- L04 --- L04 --- L04 --- L04 --- L04 L04 L04 --- L04 --- L04 --- L04 --- L04 --- L04 --- L04 --- L04 --- L04 --- 
L04 --- L04 --- L04 --- L04 --- L04 L04 L04 --- L04 --- L04 --- L04 --- L04 --- L04 --- L04 --- L04 --- L04 --- L04 --- L04 --- L04 --- L04 
--- L04 --- L04 --- L04 --- L04 L04 L04 --- L04 --- L04 --- L04 --- L04 --- L04 --- L04 --- L04 --- L04 --- L04 --- L04 --- L04 --- L04 --- 
L04 --- L04 --- L04 --- L04 --- L04 --- L04 --- L04 --- L04 --- L04 --- L04 --- L04 --- L04 --- L04 --- L04 --- L04 --- L04 --- L04 --- L04 
--- --- --- L04 --- L04 --- L04 --- L04 --- L04 --- L04 --- L04 --- L04 --- L04 --- L04 --- L04 --- L04 --- L04 --- L04 --- L04 --- L04 --- 
--- --- L04 --- L04 --- L04 L04 L04 --- L04 --- L04 --- L04 --- L04 --- L04 --- L04 --- L04 --- L04 --- L04 --- L04 --- L04 --- L04 --- L04 
layer1
--- T00 --- --- --- --- T00 --- --- --- --- --- --- --- --- --- --- --- --- --- --- --- --- --- T00 --- --- --- T00 --- --- T00 --- --- --- 
--- --- --- --- --- --- --- --- --- --- --- --- --- --- --- --- --- --- --- --- --- --- --- --- --- --- --- T01 --- --- --- --- --- --- --- 
--- --- --- --- --- --- --- --- --- --- --- --- --- --- --- --- --- --- --- --- --- --- --- --- G00 --- --- --- T00 T00 --- --- --- --- --- 
--- --- --- --- --- G00 --- G03 --- --- --- --- --- --- --- --- --- --- --- --- --- --- --- --- --- G08 --- --- --- --- --- --- --- --- --- 
T00 --- --- --- --- --- --- --- --- --- --- --- --- --- --- --- --- --- --- --- --- --- --- --- --- --- G03 --- T01 --- --- --- --- --- --- 
--- --- --- --- T00 --- --- --- --- --- --- --- --- --- --- --- --- --- --- --- --- --- --- --- --- --- --- --- --- --- T00 --- --- --- --- 
--- --- --- --- --- --- --- --- --- --- --- --- --- --- --- --- --- --- --- --- --- --- --- --- --- --- --- --- --- T01 --- --- --- --- --- 
--- --- --- --- --- --- --- --- --- --- --- --- --- --- --- --- --- --- --- --- --- --- --- --- --- --- --- --- --- --- --- T01 --- --- --- 
--- T00 T00 T00 --- --- --- --- --- --- --- --- --- --- --- --- --- --- --- --- --- --- --- --- --- --- --- --- --- --- T00 --- --- --- --- 
T00 --- --- --- --- --- --- --- --- --- --- --- --- --- --- --- --- --- --- --- --- --- --- --- --- --- --- --- --- G03 --- T01 --- G07 --- 
--- --- --- --- --- --- --- --- --- --- --- --- --- --- --- --- --- --- --- --- --- --- --- --- --- --- --- --- --- --- --- --- --- --- --- 
--- --- --- --- G03 --- --- --- --- --- --- --- --- --- --- --- --- --- --- --- --- --- --- --- --- --- --- --- --- --- --- --- T00 --- --- 
T01 --- --- --- --- --- --- --- --- --- --- --- --- --- --- --- --- --- --- --- --- --- --- --- --- --- --- --- --- --- --- --- --- --- --- 
--- --- --- --- --- --- --- --- --- --- --- --- --- --- --- --- --- --- --- --- --- --- --- --- --- --- --- --- --- --- --- --- --- --- --- 
--- --- --- --- --- --- --- --- --- --- --- --- --- --- --- --- --- --- --- --- --- --- --- --- --- --- --- --- --- --- --- --- --- --- --- 
--- --- --- --- --- --- --- --- --- --- --- --- --- --- --- --- --- --- --- --- --- --- --- --- --- --- --- --- --- --- --- --- --- --- --- 
--- --- G00 --- --- --- --- --- --- --- --- --- --- --- --- --- --- --- --- --- --- --- --- --- --- --- --- --- --- --- --- --- --- --- --- 
--- --- --- --- --- --- --- --- --- --- --- --- --- --- --- --- --- --- --- --- --- --- --- --- --- --- --- --- --- --- --- --- --- --- --- 
--- --- --- --- --- --- G09 --- --- --- --- --- --- --- --- --- --- --- --- --- --- --- --- --- --- --- --- --- --- --- --- T01 --- --- --- 
--- --- --- --- --- --- --- --- --- --- --- --- --- --- --- --- --- --- --- --- --- --- --- --- --- --- --- --- --- --- T00 --- --- --- --- 
--- --- --- --- --- --- --- G09 --- --- --- --- --- --- --- --- --- --- --- --- --- --- --- --- --- --- --- --- --- --- --- --- --- --- --- 
--- --- --- --- --- G09 --- --- --- --- --- --- --- --- --- --- --- --- --- --- --- --- --- --- --- --- --- --- --- --- --- --- --- --- --- 
--- --- G03 --- G07 --- --- --- --- --- --- --- --- --- --- --- --- --- --- --- --- --- --- --- --- --- --- --- --- --- --- --- --- --- --- 
--- --- --- --- --- --- --- --- --- --- --- --- --- --- --- --- --- --- --- --- --- --- --- --- --- --- --- --- --- --- --- --- --- --- --- 
--- --- --- --- --- --- --- --- --- --- --- --- --- --- --- --- --- --- --- --- --- --- --- --- --- --- --- --- --- --- --- --- --- --- --- 
--- --- --- --- --- --- --- --- --- --- --- --- --- --- --- --- --- --- --- --- --- --- --- --- --- --- --- --- --- --- --- --- --- --- --- 
--- --- --- --- --- --- --- --- --- --- --- --- --- --- --- --- --- --- --- --- --- --- --- --- --- --- --- --- --- --- --- --- --- --- --- 
--- --- --- --- --- --- --- --- --- --- --- --- --- --- --- --- --- --- --- --- --- --- --- --- --- --- --- --- --- --- --- --- --- --- --- 
--- --- --- --- --- --- --- --- --- --- --- --- --- --- --- --- --- --- --- --- --- --- --- --- --- --- --- --- --- --- --- --- --- --- --- 
--- --- --- --- --- --- --- --- --- --- --- --- --- --- --- --- --- --- --- --- --- --- --- --- --- --- --- --- --- --- --- T00 --- --- --- 
--- --- --- --- --- --- --- --- --- --- --- --- --- --- --- --- --- --- --- --- --- --- --- --- --- --- --- --- --- --- --- --- --- --- --- 
--- --- --- --- --- --- --- --- --- --- --- --- --- --- --- --- --- --- --- --- --- --- --- --- --- --- --- --- --- --- --- --- --- --- --- 
--- --- --- --- --- --- --- --- --- --- --- --- L0P --- --- --- T00 --- --- --- --- --- --- --- --- --- --- --- --- --- --- --- --- --- --- 
--- --- --- --- --- --- --- --- --- --- --- --- --- --- --- --- --- --- --- --- --- --- --- --- --- --- --- --- --- T00 --- T00 --- --- --- 
--- --- --- --- --- --- --- --- --- --- --- --- --- --- --- --- --- --- --- --- --- --- --- --- --- --- --- --- --- --- --- --- --- --- --- 
--- --- --- --- --- --- --- --- --- --- --- --- --- --- T00 T00 T00 --- T00 T00 --- --- T00 --- --- T00 --- T00 T00 --- --- T01 --- --- --- 
--- --- --- --- --- --- --- --- --- --- --- --- --- --- --- --- --- --- --- --- --- --- --- --- --- --- --- --- --- --- --- --- --- --- --- 
--- --- --- --- --- --- --- --- --- --- --- --- --- --- --- --- --- --- --- --- --- --- T00 --- --- T00 --- --- --- --- --- --- --- --- --- 
--- --- --- --- --- --- --- --- --- --- --- T00 --- --- --- --- --- --- --- --- --- --- --- --- --- --- --- --- --- --- --- --- --- --- --- 
--- --- --- --- --- --- --- --- T01 --- --- --- --- --- --- --- --- --- --- --- --- --- --- --- --- --- --- --- --- --- --- --- --- --- --- 
--- --- --- --- --- --- --- --- --- --- --- --- --- --- --- --- --- --- --- --- --- T00 --- --- --- --- --- --- --- --- --- --- --- --- --- 
--- --- --- --- --- --- --- --- T00 --- --- --- --- T00 --- --- T00 --- --- --- --- --- --- --- --- --- --- --- --- --- T00 --- --- --- --- 
--- --- --- --- --- --- --- --- --- T00 --- --- --- --- --- --- --- --- --- --- --- --- --- --- T00 --- --- --- --- T01 --- --- --- --- --- 
T00 --- --- --- --- --- --- --- --- --- --- T00 --- --- --- --- --- --- --- --- --- --- --- --- G07 --- T01 T00 --- --- --- --- --- --- --- 
--- --- T01 --- --- T01 --- --- --- --- --- --- --- --- --- --- --- --- T01 --- --- --- T01 --- --- --- --- --- --- --- --- --- --- --- --- 
--- --- --- --- T00 --- T00 --- --- --- --- --- --- --- --- --- --- --- --- --- --- --- --- --- --- --- --- G03 --- --- --- --- --- --- --- 
--- --- --- --- --- --- --- --- --- --- --- --- --- --- --- G06 --- --- --- --- --- --- --- --- --- --- --- --- --- --- --- --- --- --- --- 
--- --- --- --- --- --- --- --- --- --- --- --- --- --- --- --- --- G03 --- --- --- --- --- --- --- G03 --- --- --- --- --- --- G03 --- --- 
--- --- --- --- --- --- --- --- --- --- --- --- G00 --- --- --- --- --- --- --- G07 --- G03 --- --- --- --- --- --- G03 --- --- --- --- --- 
--- --- --- --- --- --- --- --- --- --- --- --- --- --- --- --- --- --- --- --- --- --- --- --- --- --- --- --- --- --- --- --- --- --- --- 
--- --- --- --- --- --- --- --- --- --- --- --- --- --- --- --- --- --- --- --- --- --- --- --- --- --- --- --- --- --- --- --- --- --- --- 
--- --- --- --- --- --- --- --- --- --- --- --- --- --- --- --- --- --- --- --- --- --- --- --- --- --- --- --- --- --- --- --- --- --- --- 
--- --- --- --- --- --- --- --- --- --- --- --- --- --- --- --- --- --- --- --- --- --- --- --- --- --- --- --- --- --- --- --- --- --- --- 
layer2
--- --- --- --- --- --- --- --- --- --- --- --- --- --- --- --- --- --- --- --- --- --- --- --- --- --- --- --- --- --- --- --- --- --- --- 
--- --- --- --- --- --- --- --- --- --- --- --- --- --- --- --- --- --- --- --- --- --- --- --- --- --- --- --- --- --- --- --- --- --- --- 
--- --- --- --- --- --- --- --- --- --- --- --- --- --- --- --- --- --- --- --- --- --- --- --- --- --- --- --- --- --- --- --- --- --- --- 
--- --- --- --- --- --- --- --- --- --- --- --- --- --- --- --- --- --- --- --- --- --- --- --- --- --- --- --- --- --- --- --- --- --- --- 
--- --- --- --- --- --- --- --- --- --- --- --- --- --- --- --- R09 R04 --- --- --- --- --- --- --- --- --- --- --- --- --- --- --- --- --- 
--- --- --- --- --- --- --- --- --- --- --- --- --- --- --- R09 --- --- R04 --- --- --- --- --- --- --- --- --- --- --- --- --- --- --- --- 
--- --- --- --- --- --- --- --- --- --- --- --- --- --- R09 --- --- --- --- R04 --- --- --- --- --- --- --- --- --- --- --- --- --- --- --- 
--- --- --- --- --- --- --- --- --- --- --- --- --- R09 --- M00 --- --- --- --- R04 --- --- --- --- --- --- --- --- --- --- --- --- --- --- 
--- --- --- --- --- --- --- --- --- --- --- --- R09 --- --- --- --- --- --- --- --- R04 --- --- --- --- --- --- --- --- --- --- --- --- --- 
--- --- --- --- --- --- --- --- --- --- --- R09 --- --- --- --- --- --- --- --- --- --- R04 --- --- --- --- --- --- --- --- --- --- --- --- 
--- --- --- --- --- --- --- --- --- --- R09 --- --- --- --- --- --- --- --- --- --- --- --- R04 --- --- --- --- --- --- --- --- --- --- --- 
--- --- --- --- --- --- --- --- --- R09 --- M00 --- --- --- --- --- --- --- --- --- --- --- --- R04 --- --- --- --- --- --- --- --- --- --- 
--- --- --- --- --- --- --- --- R09 --- --- --- --- B01 --- --- --- --- --- --- --- --- --- --- --- R04 --- --- --- --- --- --- --- --- --- 
--- --- --- --- --- --- --- --- R04 --- --- --- --- --- --- --- --- --- --- --- --- --- --- --- --- --- R04 --- --- --- --- --- --- --- --- 
--- --- --- --- --- --- --- --- --- R04 --- --- --- --- --- --- --- --- --- --- --- --- --- --- --- --- --- R04 --- --- --- --- --- --- --- 
--- --- --- --- --- --- --- --- --- --- R04 --- --- --- --- --- --- --- --- --- --- --- --- --- --- --- --- --- R04 --- --- --- --- --- --- 
--- --- --- --- --- --- --- --- --- --- --- R04 --- --- --- --- --- --- --- --- --- --- --- --- --- --- --- --- --- R04 --- --- --- --- --- 
--- --- --- --- --- --- --- --- --- --- --- --- R06 --- --- --- --- --- --- --- --- --- --- --- --- --- --- --- --- --- R04 --- --- --- --- 
--- --- --- --- --- --- --- --- --- --- --- --- --- R04 --- --- --- --- --- --- --- --- --- --- --- --- --- --- --- --- --- R04 --- --- --- 
--- --- --- --- --- --- --- --- --- --- --- --- --- --- --- --- --- --- --- --- --- --- --- --- --- --- --- --- --- --- --- --- R04 --- --- 
--- --- --- --- --- --- --- --- --- --- --- --- --- --- --- --- --- --- --- --- --- --- --- --- --- --- --- --- --- --- --- --- R09 --- --- 
--- --- --- --- --- --- --- --- --- --- --- --- --- --- --- --- R04 --- --- --- --- --- --- --- --- --- --- --- --- --- --- R09 --- --- --- 
--- --- --- --- --- --- --- --- --- --- --- --- --- --- --- --- --- R06 --- --- --- --- --- --- --- --- --- --- --- --- R09 --- --- --- --- 
--- --- --- --- --- --- --- --- --- --- --- --- --- --- --- --- --- --- R04 --- --- --- --- --- --- --- --- --- --- R09 --- --- --- --- --- 
--- --- --- --- --- --- --- --- --- --- --- --- --- --- --- --- --- --- --- R04 --- --- --- --- --- --- --- --- R09 --- --- --- --- --- --- 
--- --- --- --- --- --- --- --- --- --- --- --- --- --- --- --- --- --- --- --- R04 --- --- --- --- --- --- R09 --- --- --- --- --- --- --- 
--- --- --- --- --- --- --- --- --- --- --- --- --- --- --- --- --- --- --- --- --- R04 --- --- --- --- R09 --- --- --- --- --- --- --- --- 
--- --- --- --- --- --- --- --- --- --- --- --- --- --- --- --- --- --- --- --- --- --- R04 --- --- R09 --- --- --- --- --- --- --- --- --- 
--- --- --- --- --- --- --- --- --- --- --- --- --- --- --- --- --- --- --- --- --- --- --- R04 R09 --- --- --- --- --- --- --- --- --- --- 
--- --- --- --- --- --- --- --- --- --- --- --- --- --- --- --- --- --- --- --- --- --- --- --- --- --- --- --- --- --- --- --- --- --- --- 
--- --- --- --- --- --- --- --- --- --- --- --- --- --- --- --- --- --- --- --- --- --- --- --- --- --- --- --- --- --- --- --- --- --- --- 
--- --- --- --- --- --- --- --- --- --- --- --- --- --- --- --- --- --- --- --- --- --- --- --- --- --- --- --- --- --- --- --- --- --- --- 
--- --- --- --- --- --- --- --- --- --- --- --- --- --- --- --- --- --- --- --- --- --- --- --- --- --- --- --- --- --- --- --- --- --- --- 
--- --- --- --- --- --- --- --- --- --- --- --- --- --- --- --- --- --- --- --- --- --- --- --- --- --- --- --- --- --- --- --- --- --- --- 
--- --- --- --- --- --- --- --- --- --- --- --- --- --- --- --- --- --- --- --- --- --- --- --- --- --- --- --- --- --- --- --- --- --- --- 
--- --- --- --- --- --- --- --- --- --- --- --- --- --- --- --- --- --- --- --- --- --- --- --- --- --- --- --- --- --- --- --- --- --- --- 
--- --- --- --- --- --- --- --- --- --- --- --- --- --- --- --- --- --- --- --- --- --- --- --- --- --- --- --- --- --- --- --- --- --- --- 
--- --- --- --- --- --- --- --- --- --- --- --- --- --- --- --- --- --- --- --- --- --- --- --- --- --- --- --- --- --- --- --- --- --- --- 
--- --- --- --- --- --- --- --- --- --- --- --- --- --- --- --- --- --- --- --- --- --- --- --- --- --- --- --- --- --- --- --- --- --- --- 
--- --- --- --- --- --- --- --- --- --- --- --- --- --- --- --- --- --- --- --- --- --- --- --- --- --- --- --- --- --- --- --- --- --- --- 
--- --- --- --- --- --- --- --- --- --- --- --- --- --- --- --- --- --- --- --- --- --- --- --- --- --- --- --- --- --- --- --- --- --- --- 
--- --- --- --- --- --- --- --- --- --- --- --- --- --- --- --- --- --- --- --- --- --- --- --- --- --- --- --- --- --- --- --- --- --- --- 
--- --- --- --- --- --- --- --- --- --- --- --- --- --- --- --- --- --- --- --- --- --- --- --- --- --- --- --- --- --- --- --- --- --- --- 
--- --- --- --- --- --- --- --- --- --- --- --- --- --- --- --- --- --- --- --- --- --- --- --- --- --- --- --- --- --- --- --- --- --- --- 
--- --- --- --- --- --- --- --- --- --- --- --- --- --- --- --- --- --- --- --- --- --- --- --- --- --- --- --- --- --- --- --- --- --- --- 
--- --- --- --- --- --- --- --- --- --- --- --- --- --- --- --- --- --- --- --- --- --- --- --- --- --- --- --- --- --- --- --- --- --- --- 
--- --- --- --- --- --- --- --- --- --- --- --- --- --- --- --- --- --- --- --- --- --- --- --- --- --- --- --- --- --- --- --- --- --- --- 
--- --- --- --- --- --- --- --- --- --- --- --- --- --- --- --- --- --- --- --- --- --- --- --- --- --- --- --- --- --- --- --- --- --- --- 
--- --- --- --- --- --- --- --- --- --- --- --- --- --- --- --- --- --- --- --- --- --- --- --- --- --- --- --- --- --- --- --- --- --- --- 
--- --- --- --- --- --- --- --- --- --- --- --- --- --- --- --- --- --- --- --- --- --- --- --- --- --- --- --- --- --- --- --- --- --- --- 
--- --- --- --- --- --- --- --- --- --- --- --- --- --- --- --- --- --- --- --- --- --- --- --- --- --- --- --- --- --- --- --- --- --- --- 
--- --- --- --- --- --- --- --- --- --- --- --- --- --- --- --- --- --- --- --- --- --- --- --- --- --- --- --- --- --- --- --- --- --- --- 
--- --- --- --- --- --- --- --- --- --- --- --- --- --- --- --- --- --- --- --- --- --- --- --- --- --- --- --- --- --- --- --- --- --- --- 
layer3
--- --- --- --- --- --- --- --- --- --- --- --- --- --- --- --- --- --- --- --- --- --- --- --- --- --- --- --- --- --- --- --- --- --- --- 
--- --- --- --- --- --- --- --- --- --- --- --- --- --- --- --- --- --- --- --- --- --- --- --- --- --- --- --- --- --- --- --- --- --- --- 
--- --- --- --- --- --- --- --- --- --- --- --- --- --- --- --- --- --- --- --- --- --- --- --- --- --- --- --- --- --- --- --- --- --- --- 
--- --- --- --- --- --- --- --- --- --- --- --- --- --- --- --- --- --- --- --- --- --- --- --- --- --- --- --- --- --- --- --- --- --- --- 
--- --- --- --- --- --- --- --- --- --- --- --- --- --- --- --- --- --- --- --- --- --- --- --- --- --- --- --- --- --- --- --- --- --- --- 
--- --- --- --- --- --- --- --- --- --- --- --- --- --- --- --- --- --- --- --- --- --- --- --- --- --- --- --- --- --- --- --- --- --- --- 
--- --- --- --- --- --- --- --- --- --- --- --- --- --- --- --- --- --- --- --- --- --- --- --- --- --- --- --- --- --- --- --- --- --- --- 
--- --- --- --- --- --- --- --- --- --- --- --- --- --- --- --- --- --- --- --- --- --- --- --- --- --- --- --- --- --- --- --- --- --- --- 
--- --- --- --- --- --- --- --- --- --- --- --- --- --- --- --- --- --- --- --- --- --- --- --- --- --- --- --- --- --- --- --- --- --- --- 
--- --- --- --- --- --- --- --- --- --- --- --- --- --- --- --- --- --- --- --- --- --- --- --- --- --- --- --- --- --- --- --- --- --- --- 
--- --- --- --- --- --- --- --- --- --- --- --- --- --- --- --- --- --- --- --- --- --- --- --- --- --- --- --- --- --- --- --- --- --- --- 
--- --- --- --- --- --- --- --- --- --- --- --- --- --- --- --- --- --- --- --- --- --- --- --- --- --- --- --- --- --- --- --- --- --- --- 
--- --- --- --- --- --- --- --- --- --- --- --- --- --- --- --- --- --- --- --- --- --- --- --- --- --- --- --- --- --- --- --- --- --- --- 
--- --- --- --- --- --- --- --- --- --- --- --- --- --- --- --- --- --- --- --- --- --- --- --- --- --- --- --- --- --- --- --- --- --- --- 
--- --- --- --- --- --- --- --- --- --- --- --- --- --- --- --- --- --- --- --- --- --- --- --- --- --- --- --- --- --- --- --- --- --- --- 
--- --- --- --- --- --- --- --- --- --- --- --- --- --- --- --- --- --- --- --- --- --- --- --- --- --- --- --- --- --- --- --- --- --- --- 
--- --- --- --- --- --- --- --- --- --- --- --- --- --- --- --- --- --- --- --- --- --- --- --- --- --- --- --- --- --- --- --- --- --- --- 
--- --- --- --- --- --- --- --- --- --- --- --- --- --- --- --- --- --- --- --- --- --- --- --- --- --- --- --- --- --- --- --- --- --- --- 
--- --- --- --- --- --- --- --- --- --- --- --- --- --- --- --- --- --- --- --- --- --- --- --- --- --- --- --- --- --- --- --- --- --- --- 
--- --- --- --- --- --- --- --- --- --- --- --- --- --- --- --- --- --- --- --- --- --- --- --- --- --- --- --- --- --- --- --- --- --- --- 
--- --- --- --- --- --- --- --- --- --- --- --- --- --- --- --- --- --- --- --- --- --- --- --- --- --- --- --- --- --- --- --- --- --- --- 
--- --- --- --- --- --- --- --- --- --- --- --- --- --- --- --- --- --- --- --- --- --- --- --- --- --- --- --- --- --- --- --- --- --- --- 
--- --- --- --- --- --- --- --- --- --- --- --- --- --- --- --- --- --- --- --- --- --- --- --- --- --- --- --- --- --- --- --- --- --- --- 
--- --- --- --- --- --- --- --- --- --- --- --- --- --- --- --- --- --- --- --- --- --- --- --- --- --- --- --- --- --- --- --- --- --- --- 
--- --- --- --- --- --- --- --- --- --- --- --- --- --- --- --- --- --- --- --- --- --- --- --- --- --- --- --- --- --- --- --- --- --- --- 
--- --- --- --- --- --- --- --- --- --- --- --- --- --- --- --- --- --- --- --- --- --- --- --- --- --- --- --- --- --- --- --- --- --- --- 
--- --- --- --- --- --- --- --- --- --- --- --- --- --- --- --- --- --- --- --- --- --- --- --- --- --- --- --- --- --- --- --- --- --- --- 
--- --- --- --- --- --- --- --- --- --- --- --- --- --- --- --- --- --- --- --- --- --- --- --- --- --- --- --- --- --- --- --- --- --- --- 
--- --- --- --- --- --- --- --- --- --- --- --- --- --- --- --- --- --- --- --- --- --- --- --- --- --- --- --- --- --- --- --- --- --- --- 
--- --- --- --- --- --- --- --- --- --- --- --- --- --- --- --- --- --- --- --- --- --- --- --- --- --- --- --- --- --- --- --- --- --- --- 
--- --- --- --- --- --- --- --- --- --- --- --- --- --- --- --- --- --- --- --- --- --- --- --- --- --- --- --- --- --- --- --- --- --- --- 
--- --- --- --- --- --- --- --- --- --- --- --- --- --- --- --- --- --- --- --- --- --- --- --- --- --- --- --- --- --- --- --- --- --- --- 
--- --- --- --- --- --- --- --- --- --- --- --- --- --- --- --- --- --- --- --- --- --- --- --- --- --- --- --- --- --- --- --- --- --- --- 
--- --- --- --- --- --- --- --- --- --- --- --- --- --- --- --- --- --- --- --- --- --- --- --- --- --- --- --- --- --- --- --- --- --- --- 
--- --- --- --- --- --- --- --- --- --- --- --- --- --- --- --- --- --- --- --- --- --- --- --- --- --- --- --- --- --- --- --- --- --- --- 
--- --- --- --- --- --- --- --- --- --- --- --- --- --- --- --- --- --- --- --- --- --- --- --- --- --- --- --- --- --- --- --- --- --- --- 
--- --- --- --- --- --- --- --- --- --- --- --- --- --- --- --- --- --- --- --- --- --- --- --- --- --- --- --- --- --- --- --- --- --- --- 
--- --- --- --- --- --- --- --- --- --- --- --- --- --- --- --- --- --- --- --- --- --- --- --- --- --- --- --- --- --- --- --- --- --- --- 
--- --- --- --- --- --- --- --- --- --- --- --- --- --- --- --- --- --- --- --- --- --- --- --- --- --- --- --- --- --- --- --- --- --- --- 
--- --- --- --- --- --- --- --- --- --- --- --- --- --- --- --- --- --- --- --- --- --- --- --- --- --- --- --- --- --- --- --- --- --- --- 
--- --- --- --- --- --- --- --- --- --- --- --- --- --- --- --- --- --- --- --- --- --- --- --- --- --- --- --- --- --- --- --- --- --- --- 
--- --- --- --- --- --- --- --- --- --- --- --- --- --- --- --- --- --- --- --- --- --- --- --- --- --- --- --- --- --- --- --- --- --- --- 
--- --- --- --- --- --- --- --- --- --- --- --- --- --- --- --- --- --- --- --- --- --- --- --- --- --- --- --- --- --- --- --- --- --- --- 
--- --- --- --- --- --- --- --- --- --- --- --- --- --- --- --- --- --- --- --- --- --- --- --- --- --- --- --- --- --- --- --- --- --- --- 
--- --- --- --- --- --- --- --- --- --- --- --- --- --- --- --- --- --- --- --- --- --- --- --- --- --- --- --- --- --- --- --- --- --- --- 
--- --- --- --- --- --- --- --- --- --- --- --- --- --- --- --- --- --- --- --- --- --- --- --- --- --- --- --- --- --- --- --- --- --- --- 
--- --- --- --- --- --- --- --- --- --- --- --- --- --- --- --- --- --- --- --- --- --- --- --- --- --- --- --- --- --- --- --- --- --- --- 
--- --- --- --- --- --- --- --- --- --- --- --- --- --- --- --- --- --- --- --- --- --- --- --- --- --- --- --- --- --- --- --- --- --- --- 
--- --- --- --- --- --- --- --- --- --- --- --- --- --- --- --- --- --- --- --- --- --- --- --- --- --- --- --- --- --- --- --- --- --- --- 
--- --- --- --- --- --- --- --- --- --- --- --- --- --- --- --- --- --- --- --- --- --- --- --- --- --- --- --- --- --- --- --- --- --- --- 
--- --- --- --- --- --- --- --- --- --- --- --- --- --- --- --- --- --- --- --- --- --- --- --- --- --- --- --- --- --- --- --- --- --- --- 
--- --- --- --- --- --- --- --- --- --- --- --- --- --- --- --- --- --- --- --- --- --- --- --- --- --- --- --- --- --- --- --- --- --- --- 
--- --- --- --- --- --- --- --- --- --- --- --- --- --- --- --- --- --- --- --- --- --- --- --- --- --- --- --- --- --- --- --- --- --- --- 
