layer0
--- --- --- --- L0X L0X L0X L0X L0X L0X L0X L0X L0X L0X L0X L0X L0X L0X L0X L0X L0X L0X L0X L0X L0X L0X L0X L0X L0X L0X L0X L0X L0X L0X L0X 
--- --- --- --- --- --- --- --- L0X L0X L0X L0X L0X L0X L0X --- L0X L0X L0X L0X L0X L0X L0X L0X L0X L0X --- L0X L0X L0X L0X L0X L0X L0X L0X 
--- --- --- --- --- --- --- --- L0X L0X L0X L0X L0X --- L0X L0X L0X --- L0X L0X L0X L0X L0X L0X L0X L0X L0X L0X L0X L0X L0X L0X L0X L0X L0X 
--- --- --- --- --- --- --- --- --- L0X L0X L0X L0X L0X L0X L0X L0X L0X L0X --- L0X L0X L0X L0X L0X L0X L0X L0X L0X L0X L0X L0X L0X L0X L0X 
--- --- --- --- --- --- --- --- --- --- L0X L0X --- L0X L0X L0X L0X L0X L0X L0X L0X L0X L0X L0X L0X L0X L0X L0X L0X L0X L0X L0X L0X L0X L0X 
--- --- --- --- --- --- --- --- --- --- --- L0X L0X L0X L0X L0X L0X L0X L0X L0X L0X L0X L0X L0X L0X L0X L0X L0X L0X L0X L0X L0X L0X L0X L0X 
--- T02 --- --- --- --- --- --- --- --- --- L0X L0X L0X L0X L0X L0X L0X L0X L0X L0X L0X L0X L0X L0X L0X L0X L0X L0X L0X L0X L0X L0X L0X L0X 
--- --- --- --- --- --- --- --- --- --- --- --- L0X L0X L0X L0X L0X L0X L0X L0X L0X L0X L0X L0X L0X L0X L0X L0X L0X L0X L0X L0X L0X L0X L0X 
--- --- T00 --- --- --- --- --- --- --- --- --- L0X L0X --- L0X L0X L0X L0X L0X L0X L0X L0X L0X L0X L0X L0X L0X L0X L0X L0X L0X L0X L0X L0X 
--- --- --- T00 --- --- --- --- --- --- --- --- --- L0X L0X --- L0X L0X L0X L0X L0X L0X L0X L0X L0X L0X L0X L0X L0X L0X L0X L0X L0X L0X L0X 
--- --- --- --- --- --- --- --- --- --- --- --- --- --- L0X L0X --- L0X L0X L0X L0X L0X L0X L0X L0X L0X L0X L0X L0X L0X L0X L0X L0X L0X L0X 
--- --- --- --- --- --- --- --- --- --- --- --- --- --- --- L0X L0X --- L0X L0X L0X L0X L0X L0X L0X L0X L0X L0X L0X L0X L0X L0X L0X L0X L0X 
--- --- --- --- --- --- --- --- --- --- --- --- --- --- --- --- L0X L0X L0X L0X L0X L0X L0X L0X L0X L0X L0X L0X L0X L0X L0X L0X L0X L0X L0X 
T02 --- --- --- --- --- --- --- --- --- --- --- --- --- --- --- L0X L0X --- L0X L0X --- L0X L0X L0X L0X L0X L0X L0X L0X L0X L0X L0X L0X L0X 
--- --- --- --- --- --- --- --- --- --- --- --- --- --- --- --- --- L0X L0X --- L0X L0X L0X L0X L0X L0X L0X L0X L0X L0X L0X L0X L0X L0X L0X 
--- --- --- --- --- --- --- --- --- --- --- --- --- --- --- --- --- R0A R0G L0X --- L0X L0X L0X L0X L0X L0X L0X L0X L0X L0X L0X L0X L0X L0X 
--- --- --- --- --- --- --- --- --- --- --- --- --- --- --- --- R0A --- --- R0H L0X L0X L0X L0X L0X L0X L0X L0X L0X L0X L0X L0X --- L0X L0X 
--- --- --- --- --- --- --- --- --- --- --- --- --- --- --- R0A --- --- --- --- R0H L0X --- L0X L0X L0X L0X --- L0X L0X L0X L0X L0X L0X L0X 
--- --- --- --- --- --- --- --- --- --- --- --- --- --- R0A --- --- --- --- --- --- R0H L0X --- L0X L0X L0X L0X L0X L0X L0X L0X L0X L0X L0X 
G07 --- --- --- --- --- --- --- --- --- --- --- --- R0A --- --- --- --- --- --- --- --- R0H L0X --- L0X --- L0X L0X L0X L0X L0X L0X L0X L0X 
--- --- --- G04 --- G04 --- --- --- --- --- --- R0A --- --- --- --- --- --- --- --- --- --- R0H L0X --- L0X L0X L0X L0X L0X L0X L0X L0X L0X 
--- --- --- --- --- --- --- G04 --- --- L0T --- R0G --- L0Y L0Y L0Y L0Y --- --- --- --- --- --- R0H L0X --- L0X L0X L0X L0X L0X L0X L0X L0X 
--- --- G07 --- G07 --- --- --- --- L00 --- L0T --- R0G L0Y --- L0Y L0Y L0Y --- --- --- --- --- --- R04 L0X --- L0X L0X --- L0X L0X L0X L0X 
--- --- --- --- --- --- --- --- L02 --- L0U --- L0T L0Y R0G L0Y L0Y --- L0Y L0Y --- --- --- --- --- --- R04 L0X --- L0X L0X --- L0X L0X L0X 
G07 --- --- --- --- G04 --- L07 --- L09 --- L0U L0Y L0Y --- R0G L0Y L0Y --- L0Y L0Y --- --- --- --- --- --- R04 L0X --- L0X L0X --- L0X L0X 
--- --- --- --- G04 --- L0F --- L0I --- L0U L0Y L0U L0Y L0Y L0Y R0G L0Y L0Y L0Y L0Y L0Y --- --- --- --- --- --- R04 L0X --- L0X L0X L0X L0X 
G09 --- --- G09 --- --- --- L0O --- L0R --- L0U L0Y L0W L0Y L0Y L0Y L0Y L0Y --- L0Y L0Y L0Y --- --- --- --- --- R09 L0X L0X --- L0X L0X L0X 
--- --- G07 --- --- --- L0H --- L0X --- L02 --- L0W L0Y L0V L0Y L0Y --- L0Y L0Y L0Y L0Y L0Y L0Y --- --- --- R09 --- --- L0X L0X --- L0X L0X 
--- G09 L0X L0X L0X L0X --- L0X --- L0X --- L0V --- L0V L0Y L0V L0Y L0Y --- R0Y L0Y L0Y --- L0Y L0Y --- R09 --- --- --- --- L0X L0X L0X L0X 
L0X L0X --- L0X L0X L0X L0X --- L0X --- L0R --- L0S --- L0S L0Y L0V L0Y L0Y L0Y R0Y L0Y L0Y L0Y L0Y R09 --- --- R0A --- --- --- L0X --- L0X 
L0X --- L0X L0X --- L0X --- L0X L0X L0X --- L0R --- L0R --- L0M L0Y L0Y --- L0V L0Y R0Y L0Y L0Y R09 L0Y L0Y R0A --- --- --- --- --- L0X L0X 
L0X L0X L0X L0X L0X L0X L0X L0X L0X --- L0X --- L0K --- L0R --- L0E L0Y L0O --- L0Y L0Y R0Y R0A L0Y L0Y L0Y --- --- --- --- --- --- L0X L0X 
L0X L0X L0X --- L0X L0X --- L0X L0X L0X --- L0X --- L0X --- L0K --- L0E L0Y L0R --- L0Y L0Y L0Y L0Y L0Y --- L0Y --- --- --- --- --- --- --- 
L0X L0X L0X L0X L0X L0X L0X L0X L0X --- L0X L0X L0X L0X L0X L0X L0X --- L0H L0Y L0G --- L0Y L0Y R03 L0Y --- L0Y --- --- --- --- --- --- --- 
L0X L0X L0X L0X L0X L0X L0X --- L0X L0X L0X L0X L0X L0X L0X L0X L0X L0X L0X L0K L0Y T01 L0X L0Y L0Y L0Y L0Y L0Y L0Y --- --- --- --- --- --- 
L0X L0X L0X L0X L0X L0X L0X L0X --- L0X --- L0X L0X L0X L0X L0X L0X --- L0X L0X L0X L0Y L0X L0X L0X L0X --- L0Y --- --- --- --- --- --- --- 
L0X L0X L0X L0X L0X L0X --- L0X L0X L0X L0X L0X L0X L0X L0X L0X L0X L0X L0X L0X L0X L0X L0Y L0X --- L0X L0Y --- --- --- --- --- --- --- --- 
L0X L0X L0X --- L0X L0X L0X L0X L0X --- L0X L0X L0X L0X L0X L0X L0X L0X L0X L0Y L0X --- L0X L0Y L0X L0Y L0X --- --- --- --- --- --- --- --- 
L0X L0X L0X L0X L0X L0X L0X L0X L0X L0X L0X L0X L0X L0X L0X L0X L0X L0X L0X L0X T01 L0X L0X L0X L0Y L0X L0X --- --- --- --- --- --- --- --- 
L0X L0X L0X L0X --- L0X L0X L0X L0X L0X L0X T01 L0X L0X L0X L0X --- L0X L0X L0X L0X L0X L0X --- L0X T01 L0X --- --- --- --- T02 --- --- --- 
L0X L0X L0X L0X L0X L0X L0X L0X --- L0X L0X L0X L0X L0X L0X L0X L0X L0X T01 L0X L0X L0X L0X L0X L0X L0X L0X L0X --- --- --- --- --- --- --- 
L0X L0X L0X L0X L0X L0X --- L0X L0X L0X L0X L0X L0X L0X T00 L0X L0X L0X L0X --- L0X L0X L0X L0X L0X L0X L0X L0X L0X --- --- --- --- --- --- 
L0X L0X L0X L0X L0X L0X L0X T00 L0X L0X L0X L0X L0X --- L0X L0X L0X L0X L0X L0X L0X L0X L0X L0X L0X L0X L0X L0X L0X L0X --- --- --- --- --- 
L0X L0X L0X L0X L0X L0X L0X L0X L0X L0X L0X T00 L0X L0X L0X L0X L0X L0X --- L0X L0X --- L0X L0X L0X L0X L0X L0X --- T02 L0X --- --- --- --- 
L0X L0X L0X --- L0X --- L0X L0X L0X L0X L0X L0X L0X L0X L0X L0X L0X --- L0X --- L0X L0X L0X L0X L0X L0X L0X L0X L0X L0X L0X --- --- --- --- 
L0X L0X L0X L0X L0X L0X L0X L0X L0X L0X L0X L0X L0X L0X L0X L0X L0X L0X --- L0X L0X L0X L0X L0X L0X --- L0X L0X L0X L0X L0X L0X L0X L0X --- 
L0X L0X L0X L0X L0X L0X L0X L0X L0X L0X L0X L0X L0X L0X L0X --- L0X --- L0X L0X L0X L0X L0X L0X L0X L0X L0X L0X --- L0X L0X L0X L0X L0X L0X 
L0X L0X L0X L0X --- L0X L0X --- L0X L0X L0X L0X L0X L0X L0X L0X L0X L0X L0X L0X L0X L0X L0X L0X L0X L0X L0X L0X L0X --- L0X L0X L0X L0X L0X 
L0X L0X L0X L0X L0X L0X L0X L0X L0X L0X L0X L0X L0X L0X L0X L0X L0X L0X --- L0X L0X G03 --- L0X L0X L0X --- L0X L0X L0X L0X --- L0X L0X L0X 
L0X L0X L0X L0X L0X L0X L0X L0X --- L0X G03 L0X L0X --- G03 L0X G04 L0X G09 L0X L0X L0X L0X G09 L0X --- L0X G09 L0X L0X G09 L0X L0X L0X L0X 
L0X L0X --- L0X L0X L0X --- L0X G00 L0X L0X L0X L0X L0X L0X L0X L0X L0X --- L0X L0X --- L0X L0X L0X L0X L0X L0X L0X L0X L0X L0X L0X --- L0X 
L0X L0X --- L0X L0X L0X L0X L0X L0X L0X L0X L0X --- L0X L0X --- L0X L0X L0X L0X L0X L0X L0X L0X L0X L0X L0X L0X L0X L0X L0X L0X L0X L0X L0X 
L0X L0X --- L0X L0X L0X L0X L0X L0X L0X L0X L0X L0X L0X L0X L0X L0X L0X L0X L0X L0X L0X L0X L0X L0X L0X L0X L0X L0X L0X L0X L0X L0X L0X L0X 
layer1
--- --- --- --- --- --- --- --- --- --- --- --- --- --- --- --- --- --- --- --- --- --- --- --- --- --- --- --- --- --- --- --- --- --- --- 
--- --- --- --- --- --- --- --- --- --- --- --- --- --- --- --- --- --- --- --- --- --- --- --- --- --- --- --- --- --- --- --- --- --- --- 
--- --- --- --- --- --- --- --- --- --- --- --- --- --- --- --- --- --- --- --- --- --- --- --- --- --- --- --- --- --- --- --- --- --- --- 
--- --- --- --- --- --- --- --- --- --- --- --- --- --- --- --- --- --- --- --- --- --- --- --- --- --- --- --- --- --- --- --- --- --- --- 
--- --- --- --- --- --- --- --- --- --- --- --- --- --- --- --- --- --- --- --- --- --- --- --- --- --- --- --- --- --- --- --- --- --- --- 
--- --- --- --- --- --- --- --- --- --- --- --- --- --- --- --- --- --- --- --- --- --- --- --- --- --- --- --- --- --- --- --- --- --- --- 
--- --- --- --- --- --- --- --- --- --- --- --- --- --- --- --- --- --- --- --- --- --- --- --- --- --- --- --- --- --- --- --- --- --- --- 
--- --- --- --- --- --- --- --- --- --- --- --- --- --- --- --- --- --- --- --- --- --- --- --- --- --- --- --- --- --- --- --- --- --- --- 
--- --- --- --- --- --- --- --- --- --- --- --- --- --- --- --- --- --- --- --- --- --- --- --- --- --- --- --- --- --- --- --- --- --- --- 
--- --- --- --- --- --- --- --- --- --- --- --- --- --- --- --- --- --- --- --- --- --- --- --- --- --- --- --- --- --- --- --- --- --- --- 
--- --- --- --- --- --- --- --- --- --- --- --- --- --- --- --- --- --- --- --- --- --- --- --- --- --- --- --- --- --- --- --- --- --- --- 
--- --- --- --- --- --- --- --- --- --- --- --- --- --- --- --- --- --- --- --- --- --- --- --- --- --- --- --- --- --- --- --- --- --- --- 
--- --- --- --- --- --- --- --- --- --- --- --- --- --- --- --- --- --- --- --- --- --- --- --- --- --- --- --- --- --- --- --- --- --- --- 
--- --- --- --- --- --- --- --- --- --- --- --- --- --- --- --- --- --- --- --- --- --- --- --- --- --- --- --- --- --- --- --- --- --- --- 
--- --- --- --- --- --- --- --- --- --- --- --- --- --- --- --- --- --- --- --- --- --- --- --- --- --- --- --- --- --- --- --- --- --- --- 
--- --- --- --- --- --- --- --- --- --- --- --- --- --- --- --- --- --- --- --- --- --- --- --- --- --- --- --- --- --- --- --- --- --- --- 
--- --- --- --- --- --- --- --- --- --- --- --- --- --- --- --- --- --- --- --- --- --- --- --- --- --- --- --- --- --- --- --- --- --- --- 
--- --- --- --- --- --- --- --- --- --- --- --- --- --- --- --- --- --- --- --- --- --- --- --- --- --- --- --- --- --- --- --- --- --- --- 
--- --- --- --- --- --- --- --- --- --- --- --- --- --- --- --- --- --- --- --- --- --- --- --- --- --- --- --- --- --- --- --- --- --- --- 
--- --- --- --- --- --- --- --- --- --- --- --- --- --- --- --- --- --- --- --- --- --- --- --- --- --- --- --- --- --- --- --- --- --- --- 
--- --- --- --- --- --- --- --- --- --- --- --- --- --- --- --- --- --- --- --- --- --- --- --- --- --- --- --- --- --- --- --- --- --- --- 
--- --- --- --- --- --- --- --- --- --- --- --- --- --- --- --- --- --- --- --- --- --- --- --- --- --- --- --- --- --- --- --- --- --- --- 
--- --- --- --- --- --- --- --- --- --- --- --- --- --- --- --- --- --- --- --- --- --- --- --- --- --- --- --- --- --- --- --- --- --- --- 
--- --- --- --- --- --- --- --- --- --- --- --- --- --- --- --- --- --- --- --- --- --- --- --- --- --- --- --- --- --- --- --- --- --- --- 
--- --- --- --- --- --- --- --- --- --- --- --- --- --- --- --- --- --- --- --- --- --- --- --- --- --- --- --- --- --- --- --- --- --- --- 
--- --- --- --- --- --- --- --- --- --- --- --- --- --- --- --- --- --- --- --- --- --- --- --- --- --- --- --- --- --- --- --- --- --- --- 
--- --- --- --- --- --- --- --- --- --- --- --- --- --- --- --- --- --- --- --- --- --- --- --- --- --- --- --- --- --- --- --- --- --- --- 
--- --- --- --- --- --- --- --- --- --- --- --- --- --- --- --- --- --- --- --- --- --- --- --- --- --- --- --- --- --- --- --- --- --- --- 
--- --- --- --- --- --- --- --- --- --- --- --- --- --- --- --- --- --- --- --- --- --- --- --- --- --- --- --- --- --- --- --- --- --- --- 
--- --- --- --- --- --- --- --- --- --- --- --- --- --- --- --- --- --- --- --- --- --- --- --- --- --- --- --- --- --- --- --- --- --- --- 
--- --- --- --- --- --- --- --- --- --- --- --- --- --- --- --- --- --- --- --- --- --- --- --- --- --- --- --- --- --- --- --- --- --- --- 
--- --- --- --- --- --- --- --- --- --- --- --- --- --- --- --- --- --- --- --- --- --- --- --- --- --- --- --- --- --- --- --- --- --- --- 
--- --- --- --- --- --- --- --- --- --- --- --- --- --- --- --- --- --- --- --- --- --- --- --- --- --- --- --- --- --- --- --- --- --- --- 
--- --- --- --- --- --- --- --- --- --- --- --- --- --- --- --- --- --- --- --- --- --- --- --- --- --- --- --- --- --- --- --- --- --- --- 
--- --- --- --- --- --- --- --- --- --- --- --- --- --- --- --- --- --- --- --- --- --- --- --- --- --- --- --- --- --- --- --- --- --- --- 
--- --- --- --- --- --- --- --- --- --- --- --- --- --- --- --- --- --- --- --- --- --- --- --- --- --- --- --- --- --- --- --- --- --- --- 
--- --- --- --- --- --- --- --- --- --- --- --- --- --- --- --- --- --- --- --- --- --- --- --- --- --- --- --- --- --- --- --- --- --- --- 
--- --- --- --- --- --- --- --- --- --- --- --- --- --- --- --- --- --- --- --- --- --- --- --- --- --- --- --- --- --- --- --- --- --- --- 
--- --- --- --- --- --- --- --- --- --- --- --- --- --- --- --- --- --- --- --- --- --- --- --- --- --- --- --- --- --- --- --- --- --- --- 
--- --- --- --- --- --- --- --- --- --- --- --- --- --- --- --- --- --- --- --- --- --- --- --- --- --- --- --- --- --- --- --- --- --- --- 
--- --- --- --- --- --- --- --- --- --- --- --- --- --- --- --- --- --- --- --- --- --- --- --- --- --- --- --- --- --- --- --- --- --- --- 
--- --- --- --- --- --- --- --- --- --- --- --- --- --- --- --- --- --- --- --- --- --- --- --- --- --- --- --- --- --- --- --- --- --- --- 
--- --- --- --- --- --- --- --- --- --- --- --- --- --- --- --- --- --- --- --- --- --- --- --- --- --- --- --- --- --- --- --- --- --- --- 
--- --- --- --- --- --- --- --- --- --- --- --- --- --- --- --- --- --- --- --- --- --- --- --- --- --- --- --- --- --- --- --- --- --- --- 
--- --- --- --- --- --- --- --- --- --- --- --- --- --- --- --- --- --- --- --- --- --- --- --- --- --- --- --- --- --- --- --- --- --- --- 
--- --- --- --- --- --- --- --- --- --- --- --- --- --- --- --- --- --- --- --- --- --- --- --- --- --- --- --- --- --- --- --- --- --- --- 
--- --- --- --- --- --- --- --- --- --- --- --- --- --- --- --- --- --- --- --- --- --- --- --- --- --- --- --- --- --- --- --- --- --- --- 
--- --- --- --- --- --- --- --- --- --- --- --- --- --- --- --- --- --- --- --- --- --- --- --- --- --- --- --- --- --- --- --- --- --- --- 
--- --- --- --- --- --- --- --- --- --- --- --- --- --- --- --- --- --- --- --- --- --- --- --- --- --- --- --- --- --- --- --- --- --- --- 
--- --- --- --- --- --- --- --- --- --- --- --- --- --- --- --- --- --- --- --- --- --- --- --- --- --- --- --- --- --- --- --- --- --- --- 
--- --- --- --- --- --- --- --- --- --- --- --- --- --- --- --- --- --- --- --- --- --- --- --- --- --- --- --- --- --- --- --- --- --- --- 
--- --- --- --- --- --- --- --- --- --- --- --- --- --- --- --- --- --- --- --- --- --- --- --- --- --- --- --- --- --- --- --- --- --- --- 
--- --- --- --- --- --- --- --- --- --- --- --- --- --- --- --- --- --- --- --- --- --- --- --- --- --- --- --- --- --- --- --- --- --- --- 
layer2
--- --- --- --- --- --- --- --- --- --- --- --- --- --- --- --- --- --- --- --- --- --- --- --- --- --- --- --- --- --- --- --- --- --- --- 
--- --- --- --- --- --- --- --- --- --- --- --- --- --- --- --- --- --- --- --- --- --- --- --- --- --- --- --- --- --- --- --- --- --- --- 
--- --- --- --- --- --- --- --- --- --- --- --- --- --- --- --- --- --- --- --- --- --- --- --- --- --- --- --- --- --- --- --- --- --- --- 
--- --- --- --- --- --- --- --- --- --- --- --- --- --- --- --- --- --- --- --- --- --- --- --- --- --- --- --- --- --- --- --- --- --- --- 
--- --- --- --- --- --- --- --- --- --- --- --- --- --- --- --- --- --- --- --- --- --- --- --- --- --- --- --- --- --- --- --- --- --- --- 
--- --- --- --- --- --- --- --- --- --- --- --- --- --- --- --- --- --- --- --- --- --- --- --- --- --- --- --- --- --- --- --- --- --- --- 
--- --- --- --- --- --- --- --- --- --- --- --- --- --- --- --- --- --- --- --- --- --- --- --- --- --- --- --- --- --- --- --- --- --- --- 
--- --- --- --- --- --- --- --- --- --- --- --- --- --- --- --- --- --- --- --- --- --- --- --- --- --- --- --- --- --- --- --- --- --- --- 
--- --- --- --- --- --- --- --- --- --- --- --- --- --- --- --- --- --- --- --- --- --- --- --- --- --- --- --- --- --- --- --- --- --- --- 
--- --- --- --- --- --- --- --- --- --- --- --- --- --- --- --- --- --- --- --- --- --- --- --- --- --- --- --- --- --- --- --- --- --- --- 
--- --- --- --- --- --- --- --- --- --- --- --- --- --- --- --- --- --- --- --- --- --- --- --- --- --- --- --- --- --- --- --- --- --- --- 
--- --- --- --- --- --- --- --- --- --- --- --- --- --- --- --- --- --- --- --- --- --- --- --- --- --- --- --- --- --- --- --- --- --- --- 
--- --- --- --- --- --- --- --- --- --- --- --- --- --- --- --- --- --- --- --- --- --- --- --- --- --- --- --- --- --- --- --- --- --- --- 
--- --- --- --- --- --- --- --- --- --- --- --- --- --- --- --- --- --- --- --- --- --- --- --- --- --- --- --- --- --- --- --- --- --- --- 
--- --- --- --- --- --- --- --- --- --- --- --- --- --- --- --- --- --- --- --- --- --- --- --- --- --- --- --- --- --- --- --- --- --- --- 
--- --- --- --- --- --- --- --- --- --- --- --- --- --- --- --- --- --- --- --- --- --- --- --- --- --- --- --- --- --- --- --- --- --- --- 
--- --- --- --- --- --- --- --- --- --- --- --- --- --- --- --- --- --- --- --- --- --- --- --- --- --- --- --- --- --- --- --- --- --- --- 
--- --- --- --- --- --- --- --- --- --- --- --- --- --- --- --- --- --- --- --- --- --- --- --- --- --- --- --- --- --- --- --- --- --- --- 
--- --- --- --- --- --- --- --- --- --- --- --- --- --- --- --- --- --- --- --- --- --- --- --- --- --- --- --- --- --- --- --- --- --- --- 
--- --- --- --- --- --- --- --- --- --- --- --- --- --- --- --- --- --- --- --- --- --- --- --- --- --- --- --- --- --- --- --- --- --- --- 
--- --- --- --- --- --- --- --- --- --- --- --- --- --- --- --- --- --- --- --- --- --- --- --- --- --- --- --- --- --- --- --- --- --- --- 
--- --- --- --- --- --- --- --- --- --- --- --- --- --- --- --- --- --- --- --- --- --- --- --- --- --- --- --- --- --- --- --- --- --- --- 
--- --- --- --- --- --- --- --- --- --- --- --- --- --- --- --- --- --- --- --- --- --- --- --- --- --- --- --- --- --- --- --- --- --- --- 
--- --- --- --- --- --- --- --- --- --- --- --- --- --- --- --- --- --- --- --- --- --- --- --- --- --- --- --- --- --- --- --- --- --- --- 
--- --- --- --- --- --- --- --- --- --- --- --- --- --- --- --- --- --- --- --- --- --- --- --- --- --- --- --- --- --- --- --- --- --- --- 
--- --- --- --- --- --- --- --- --- --- --- --- --- --- --- --- --- --- --- --- --- --- --- --- --- --- --- --- --- --- --- --- --- --- --- 
--- --- --- --- --- --- --- --- --- --- --- --- --- --- --- --- --- --- --- --- --- --- --- --- --- --- --- --- --- --- --- --- --- --- --- 
--- --- --- --- --- --- --- --- --- --- --- --- --- --- --- --- --- --- --- --- --- --- --- --- --- --- --- --- --- --- --- --- --- --- --- 
--- --- --- --- --- --- --- --- --- --- --- --- --- --- --- --- --- --- --- --- --- --- --- --- --- --- --- --- --- --- --- --- --- --- --- 
--- --- --- --- --- --- --- --- --- --- --- --- --- --- --- --- --- --- --- --- --- --- --- --- --- --- --- --- --- --- --- --- --- --- --- 
--- --- --- --- --- --- --- --- --- --- --- --- --- --- --- --- --- --- --- --- --- --- --- --- --- --- --- --- --- --- --- --- --- --- --- 
--- --- --- --- --- --- --- --- --- --- --- --- --- --- --- --- --- --- --- --- --- --- --- --- --- --- --- --- --- --- --- --- --- --- --- 
--- --- --- --- --- --- --- --- --- --- --- --- --- --- --- --- --- --- --- --- --- --- --- --- --- --- --- --- --- --- --- --- --- --- --- 
--- --- --- --- --- --- --- --- --- --- --- --- --- --- --- --- --- --- --- --- --- --- --- --- --- --- --- --- --- --- --- --- --- --- --- 
--- --- --- --- --- --- --- --- --- --- --- --- --- --- --- --- --- --- --- --- --- --- --- --- --- --- --- --- --- --- --- --- --- --- --- 
--- --- --- --- --- --- --- --- --- --- --- --- --- --- --- --- --- --- --- --- --- --- --- --- --- --- --- --- --- --- --- --- --- --- --- 
--- --- --- --- --- --- --- --- --- --- --- --- --- --- --- --- --- --- --- --- --- --- --- --- --- --- --- --- --- --- --- --- --- --- --- 
--- --- --- --- --- --- --- --- --- --- --- --- --- --- --- --- --- --- --- --- --- --- --- --- --- --- --- --- --- --- --- --- --- --- --- 
--- --- --- --- --- --- --- --- --- --- --- --- --- --- --- --- --- --- --- --- --- --- --- --- --- --- --- --- --- --- --- --- --- --- --- 
--- --- --- --- --- --- --- --- --- --- --- --- --- --- --- --- --- --- --- --- --- --- --- --- --- --- --- --- --- --- --- --- --- --- --- 
--- --- --- --- --- --- --- --- --- --- --- --- --- --- --- --- --- --- --- --- --- --- --- --- --- --- --- --- --- --- --- --- --- --- --- 
--- --- --- --- --- --- --- --- --- --- --- --- --- --- --- --- --- --- --- --- --- --- --- --- --- --- --- --- --- --- --- --- --- --- --- 
--- --- --- --- --- --- --- --- --- --- --- --- --- --- --- --- --- --- --- --- --- --- --- --- --- --- --- --- --- --- --- --- --- --- --- 
--- --- --- --- --- --- --- --- --- --- --- --- --- --- --- --- --- --- --- --- --- --- --- --- --- --- --- --- --- --- --- --- --- --- --- 
--- --- --- --- --- --- --- --- --- --- --- --- --- --- --- --- --- --- --- --- --- --- --- --- --- --- --- --- --- --- --- --- --- --- --- 
--- --- --- --- --- --- --- --- --- --- --- --- --- --- --- --- --- --- --- --- --- --- --- --- --- --- --- --- --- --- --- --- --- --- --- 
--- --- --- --- --- --- --- --- --- --- --- --- --- --- --- --- --- --- --- --- --- --- --- --- --- --- --- --- --- --- --- --- --- --- --- 
--- --- --- --- --- --- --- --- --- --- --- --- --- --- --- --- --- --- --- --- --- --- --- --- --- --- --- --- --- --- --- --- --- --- --- 
--- --- --- --- --- --- --- --- --- --- --- --- --- --- --- --- --- --- --- --- --- --- --- --- --- --- --- --- --- --- --- --- --- --- --- 
--- --- --- --- --- --- --- --- --- --- --- --- --- --- --- --- --- --- --- --- --- --- --- --- --- --- --- --- --- --- --- --- --- --- --- 
--- --- --- --- --- --- --- --- --- --- --- --- --- --- --- --- --- --- --- --- --- --- --- --- --- --- --- --- --- --- --- --- --- --- --- 
--- --- --- --- --- --- --- --- --- --- --- --- --- --- --- --- --- --- --- --- --- --- --- --- --- --- --- --- --- --- --- --- --- --- --- 
--- --- --- --- --- --- --- --- --- --- --- --- --- --- --- --- --- --- --- --- --- --- --- --- --- --- --- --- --- --- --- --- --- --- --- 
layer3
--- --- --- --- --- --- --- --- --- --- --- --- --- --- --- --- --- --- --- --- --- --- --- --- --- --- --- --- --- --- --- --- --- --- --- 
--- --- --- --- --- --- --- --- --- --- --- --- --- --- --- --- --- --- --- --- --- --- --- --- --- --- --- --- --- --- --- --- --- --- --- 
--- --- --- --- --- --- --- --- --- --- --- --- --- --- --- --- --- --- --- --- --- --- --- --- --- --- --- --- --- --- --- --- --- --- --- 
--- --- --- --- --- --- --- --- --- --- --- --- --- --- --- --- --- --- --- --- --- --- --- --- --- --- --- --- --- --- --- --- --- --- --- 
--- --- --- --- --- --- --- --- --- --- --- --- --- --- --- --- --- --- --- --- --- --- --- --- --- --- --- --- --- --- --- --- --- --- --- 
--- --- --- --- --- --- --- --- --- --- --- --- --- --- --- --- --- --- --- --- --- --- --- --- --- --- --- --- --- --- --- --- --- --- --- 
--- --- --- --- --- --- --- --- --- --- --- --- --- --- --- --- --- --- --- --- --- --- --- --- --- --- --- --- --- --- --- --- --- --- --- 
--- --- --- --- --- --- --- --- --- --- --- --- --- --- --- --- --- --- --- --- --- --- --- --- --- --- --- --- --- --- --- --- --- --- --- 
--- --- --- --- --- --- --- --- --- --- --- --- --- --- --- --- --- --- --- --- --- --- --- --- --- --- --- --- --- --- --- --- --- --- --- 
--- --- --- --- --- --- --- --- --- --- --- --- --- --- --- --- --- --- --- --- --- --- --- --- --- --- --- --- --- --- --- --- --- --- --- 
--- --- --- --- --- --- --- --- --- --- --- --- --- --- --- --- --- --- --- --- --- --- --- --- --- --- --- --- --- --- --- --- --- --- --- 
--- --- --- --- --- --- --- --- --- --- --- --- --- --- --- --- --- --- --- --- --- --- --- --- --- --- --- --- --- --- --- --- --- --- --- 
--- --- --- --- --- --- --- --- --- --- --- --- --- --- --- --- --- --- --- --- --- --- --- --- --- --- --- --- --- --- --- --- --- --- --- 
--- --- --- --- --- --- --- --- --- --- --- --- --- --- --- --- --- --- --- --- --- --- --- --- --- --- --- --- --- --- --- --- --- --- --- 
--- --- --- --- --- --- --- --- --- --- --- --- --- --- --- --- --- --- --- --- --- --- --- --- --- --- --- --- --- --- --- --- --- --- --- 
--- --- --- --- --- --- --- --- --- --- --- --- --- --- --- --- --- --- --- --- --- --- --- --- --- --- --- --- --- --- --- --- --- --- --- 
--- --- --- --- --- --- --- --- --- --- --- --- --- --- --- --- --- --- --- --- --- --- --- --- --- --- --- --- --- --- --- --- --- --- --- 
--- --- --- --- --- --- --- --- --- --- --- --- --- --- --- --- --- --- --- --- --- --- --- --- --- --- --- --- --- --- --- --- --- --- --- 
--- --- --- --- --- --- --- --- --- --- --- --- --- --- --- --- --- --- --- --- --- --- --- --- --- --- --- --- --- --- --- --- --- --- --- 
--- --- --- --- --- --- --- --- --- --- --- --- --- --- --- --- --- --- --- --- --- --- --- --- --- --- --- --- --- --- --- --- --- --- --- 
--- --- --- --- --- --- --- --- --- --- --- --- --- --- --- --- --- --- --- --- --- --- --- --- --- --- --- --- --- --- --- --- --- --- --- 
--- --- --- --- --- --- --- --- --- --- --- --- --- --- --- --- --- --- --- --- --- --- --- --- --- --- --- --- --- --- --- --- --- --- --- 
--- --- --- --- --- --- --- --- --- --- --- --- --- --- --- --- --- --- --- --- --- --- --- --- --- --- --- --- --- --- --- --- --- --- --- 
--- --- --- --- --- --- --- --- --- --- --- --- --- --- --- --- --- --- --- --- --- --- --- --- --- --- --- --- --- --- --- --- --- --- --- 
--- --- --- --- --- --- --- --- --- --- --- --- --- --- --- --- --- --- --- --- --- --- --- --- --- --- --- --- --- --- --- --- --- --- --- 
--- --- --- --- --- --- --- --- --- --- --- --- --- --- --- --- --- --- --- --- --- --- --- --- --- --- --- --- --- --- --- --- --- --- --- 
--- --- --- --- --- --- --- --- --- --- --- --- --- --- --- --- --- --- --- --- --- --- --- --- --- --- --- --- --- --- --- --- --- --- --- 
--- --- --- --- --- --- --- --- --- --- --- --- --- --- --- --- --- --- --- --- --- --- --- --- --- --- --- --- --- --- --- --- --- --- --- 
--- --- --- --- --- --- --- --- --- --- --- --- --- --- --- --- --- --- --- --- --- --- --- --- --- --- --- --- --- --- --- --- --- --- --- 
--- --- --- --- --- --- --- --- --- --- --- --- --- --- --- --- --- --- --- --- --- --- --- --- --- --- --- --- --- --- --- --- --- --- --- 
--- --- --- --- --- --- --- --- --- --- --- --- --- --- --- --- --- --- --- --- --- --- --- --- --- --- --- --- --- --- --- --- --- --- --- 
--- --- --- --- --- --- --- --- --- --- --- --- --- --- --- --- --- --- --- --- --- --- --- --- --- --- --- --- --- --- --- --- --- --- --- 
--- --- --- --- --- --- --- --- --- --- --- --- --- --- --- --- --- --- --- --- --- --- --- --- --- --- --- --- --- --- --- --- --- --- --- 
--- --- --- --- --- --- --- --- --- --- --- --- --- --- --- --- --- --- --- --- --- --- --- --- --- --- --- --- --- --- --- --- --- --- --- 
--- --- --- --- --- --- --- --- --- --- --- --- --- --- --- --- --- --- --- --- --- --- --- --- --- --- --- --- --- --- --- --- --- --- --- 
--- --- --- --- --- --- --- --- --- --- --- --- --- --- --- --- --- --- --- --- --- --- --- --- --- --- --- --- --- --- --- --- --- --- --- 
--- --- --- --- --- --- --- --- --- --- --- --- --- --- --- --- --- --- --- --- --- --- --- --- --- --- --- --- --- --- --- --- --- --- --- 
--- --- --- --- --- --- --- --- --- --- --- --- --- --- --- --- --- --- --- --- --- --- --- --- --- --- --- --- --- --- --- --- --- --- --- 
--- --- --- --- --- --- --- --- --- --- --- --- --- --- --- --- --- --- --- --- --- --- --- --- --- --- --- --- --- --- --- --- --- --- --- 
--- --- --- --- --- --- --- --- --- --- --- --- --- --- --- --- --- --- --- --- --- --- --- --- --- --- --- --- --- --- --- --- --- --- --- 
--- --- --- --- --- --- --- --- --- --- --- --- --- --- --- --- --- --- --- --- --- --- --- --- --- --- --- --- --- --- --- --- --- --- --- 
--- --- --- --- --- --- --- --- --- --- --- --- --- --- --- --- --- --- --- --- --- --- --- --- --- --- --- --- --- --- --- --- --- --- --- 
--- --- --- --- --- --- --- --- --- --- --- --- --- --- --- --- --- --- --- --- --- --- --- --- --- --- --- --- --- --- --- --- --- --- --- 
--- --- --- --- --- --- --- --- --- --- --- --- --- --- --- --- --- --- --- --- --- --- --- --- --- --- --- --- --- --- --- --- --- --- --- 
--- --- --- --- --- --- --- --- --- --- --- --- --- --- --- --- --- --- --- --- --- --- --- --- --- --- --- --- --- --- --- --- --- --- --- 
--- --- --- --- --- --- --- --- --- --- --- --- --- --- --- --- --- --- --- --- --- --- --- --- --- --- --- --- --- --- --- --- --- --- --- 
--- --- --- --- --- --- --- --- --- --- --- --- --- --- --- --- --- --- --- --- --- --- --- --- --- --- --- --- --- --- --- --- --- --- --- 
--- --- --- --- --- --- --- --- --- --- --- --- --- --- --- --- --- --- --- --- --- --- --- --- --- --- --- --- --- --- --- --- --- --- --- 
--- --- --- --- --- --- --- --- --- --- --- --- --- --- --- --- --- --- --- --- --- --- --- --- --- --- --- --- --- --- --- --- --- --- --- 
--- --- --- --- --- --- --- --- --- --- --- --- --- --- --- --- --- --- --- --- --- --- --- --- --- --- --- --- --- --- --- --- --- --- --- 
--- --- --- --- --- --- --- --- --- --- --- --- --- --- --- --- --- --- --- --- --- --- --- --- --- --- --- --- --- --- --- --- --- --- --- 
--- --- --- --- --- --- --- --- --- --- --- --- --- --- --- --- --- --- --- --- --- --- --- --- --- --- --- --- --- --- --- --- --- --- --- 
--- --- --- --- --- --- --- --- --- --- --- --- --- --- --- --- --- --- --- --- --- --- --- --- --- --- --- --- --- --- --- --- --- --- --- 
